1 1 1 1 1 1 1 1 1 1 1 1 1 1 1 1 1 1 1 1 1 1 1 1
1 7 7 7 7 3 7 7 7 7 7 7 7 7 7 1 7 7 7 7 7 7 7 1
1 7 0 0 0 7 7 0 0 0 0 0 0 7 0 1 7 0 0 0 0 0 0 1
1 7 0 0 0 1 7 0 1 6 7 6 1 7 0 1 3 7 3 1 7 0 0 1
1 7 0 0 0 7 7 0 1 7 7 7 7 7 0 1 7 0 0 1 7 0 0 1
1 7 0 0 0 0 0 0 1 7 0 0 0 0 0 1 7 0 0 2 7 0 0 1
1 7 0 0 1 6 7 6 1 7 0 1 1 1 1 1 7 0 0 2 7 0 0 1
1 7 0 0 5 7 0 7 7 7 0 7 7 7 7 7 7 0 0 1 7 0 0 1
1 7 0 0 1 7 0 0 0 0 0 0 0 0 0 0 0 0 0 1 7 0 0 1
1 7 0 0 7 7 0 0 0 0 0 0 0 0 0 0 0 0 0 1 7 0 0 1
1 7 0 0 0 0 0 6 4 1 6 4 4 7 0 1 1 3 7 1 7 0 0 1
1 7 0 0 0 0 0 7 7 7 7 7 7 7 0 1 7 7 7 7 7 0 0 1
1 3 7 0 0 4 7 5 7 0 0 0 0 0 0 1 7 0 0 0 0 0 0 1
1 7 7 0 0 7 7 1 7 0 0 1 6 4 4 1 7 0 0 0 1 1 1 1
1 7 0 0 0 0 0 1 7 0 0 1 7 7 7 7 7 0 3 1 3 7 7 1
1 7 0 0 0 0 0 5 7 0 0 1 7 0 0 0 0 0 7 7 7 7 0 1
1 3 7 0 0 0 0 2 7 0 0 1 7 0 0 3 7 0 0 0 0 0 0 1
1 1 1 1 1 1 1 1 1 1 1 1 1 1 1 1 1 1 1 1 1 1 1 1