1 1 1 1 1 1 1 1 1 1 1 1 1 1 1 1 1 1 1 1 1 1 1 1
1 0 0 0 0 3 0 0 0 7 0 0 0 0 0 1 0 7 7 7 7 7 0 1
1 0 0 0 0 0 0 0 0 0 0 0 0 7 0 1 0 7 0 0 0 7 0 1
1 0 7 0 0 1 0 0 1 6 0 6 1 0 0 1 3 0 3 1 0 7 0 1
1 0 0 0 0 0 0 0 1 0 7 0 0 0 0 1 0 7 0 1 0 7 0 1
1 7 0 0 0 0 0 0 1 0 0 0 0 0 0 1 0 0 0 2 0 7 0 1
1 0 0 0 1 6 0 6 1 0 0 1 1 1 1 1 0 0 0 2 0 7 0 1
1 0 0 7 5 0 0 0 7 0 0 0 0 0 0 0 0 0 0 1 0 7 0 1
1 0 0 0 1 0 0 7 0 0 0 7 0 0 0 0 7 0 0 1 0 7 0 1
1 0 7 0 0 0 0 0 0 0 0 0 0 0 0 0 0 0 0 1 0 7 0 1
1 0 0 0 0 0 0 6 4 1 6 4 4 0 0 1 1 3 0 1 0 7 0 1
1 0 0 0 7 0 0 0 0 0 0 0 0 0 0 1 0 0 0 7 7 7 0 1
1 3 0 0 0 4 0 5 0 0 0 0 0 0 0 1 0 7 7 7 0 0 0 1
1 0 0 7 0 0 0 1 0 7 0 1 6 4 4 1 0 7 0 0 1 1 1 1
1 0 0 0 0 0 7 1 0 0 0 1 0 7 0 0 0 7 3 1 3 0 0 1
1 7 0 0 0 0 0 5 0 0 0 1 0 0 0 0 0 7 7 7 7 7 7 1
1 3 0 0 7 0 0 2 0 0 0 1 0 0 0 3 0 0 0 0 0 0 0 1
1 1 1 1 1 1 1 1 1 1 1 1 1 1 1 1 1 1 1 1 1 1 1 1