1 1 1 1 1 1 1 1 1 1 1 1 1 1 1 1 1 1 1 1 1 1 1 1
1 7 0 7 0 7 4 7 0 7 0 7 0 7 0 7 1 7 0 7 0 7 0 1
1 0 7 0 7 0 7 0 7 0 7 0 7 0 7 0 1 0 7 0 7 0 7 1
1 7 0 7 0 7 0 7 1 1 1 1 1 7 0 7 1 7 0 1 0 7 0 1
1 1 1 1 1 1 1 1 1 0 7 0 7 0 7 0 1 0 7 1 7 0 7 1
1 3 0 0 0 0 0 0 0 0 0 0 0 0 0 0 1 0 0 1 0 0 0 1
1 0 0 0 0 0 0 0 0 0 0 1 1 1 1 1 3 0 0 1 0 0 0 1
1 0 0 0 1 1 3 7 7 7 3 1 0 0 0 0 0 0 0 2 0 1 0 1
1 0 4 0 1 0 0 0 7 0 0 5 0 0 0 0 0 0 0 1 0 4 0 1
1 0 0 0 1 0 0 0 7 0 0 5 0 0 0 0 0 0 0 1 0 4 0 1
1 0 2 0 1 0 0 1 1 1 1 1 1 0 0 1 1 1 1 1 0 6 0 1
1 0 6 0 1 0 0 1 0 0 0 0 0 0 0 1 3 0 0 0 0 0 0 1
1 0 0 0 1 0 0 1 0 0 0 0 0 0 0 1 0 0 0 0 0 0 0 1
1 0 0 0 1 0 0 1 0 2 0 1 1 1 1 1 0 0 0 0 3 1 1 1
1 7 7 7 1 7 7 1 0 0 0 1 0 0 0 0 0 0 0 0 0 0 0 1
1 0 0 0 7 0 0 7 0 0 0 1 0 4 6 4 7 5 0 0 0 0 0 1
1 3 0 0 7 0 0 7 0 0 0 1 0 0 0 0 0 0 0 0 0 0 0 1
1 1 1 1 1 1 1 1 1 1 1 1 1 1 1 1 1 1 1 1 1 1 1 1