1 1 1 1 1 1 1 1 1 1 1 1 1 1 1 1 1 1 1 1 1 1 1 1
1 7 0 7 0 7 0 7 0 7 3 7 0 7 4 7 0 7 0 7 0 7 0 1
1 0 7 0 7 0 7 0 7 0 7 0 7 0 7 0 7 0 7 0 7 0 7 1
1 7 0 3 1 1 6 7 6 1 1 1 1 1 1 1 1 1 1 1 3 7 0 1
1 0 7 1 7 0 7 0 7 0 7 0 7 0 7 0 7 0 7 4 7 0 7 1
1 7 0 1 0 7 0 7 0 7 0 7 0 7 0 7 0 3 0 7 0 7 0 1
1 0 7 1 7 0 3 1 1 1 1 1 1 1 1 1 1 1 1 1 3 0 7 1
1 7 0 1 0 7 6 7 0 7 0 7 0 7 0 7 0 7 0 7 0 7 0 1
1 0 7 1 7 0 7 0 7 0 7 0 7 0 7 0 7 5 6 6 7 0 7 1
1 7 0 1 0 7 0 7 0 3 0 7 0 7 0 7 0 7 0 7 0 7 0 1
1 0 7 1 7 0 7 0 7 0 7 0 7 0 7 1 1 1 4 4 1 5 3 1
1 7 0 1 0 7 6 7 0 5 0 7 0 7 0 1 0 7 0 7 0 7 0 1
1 0 7 1 7 0 1 0 7 4 7 0 7 0 7 1 7 1 1 1 1 3 7 1
1 7 0 1 5 7 1 7 0 0 0 7 0 7 0 1 0 3 0 7 0 7 0 1
1 0 7 3 2 4 3 0 7 1 5 0 7 0 7 1 7 4 7 3 6 1 1 1
1 7 0 7 0 7 0 7 6 6 4 6 0 7 0 1 0 1 0 1 0 7 0 1
1 0 7 0 7 0 7 0 7 0 7 0 7 0 7 0 7 1 7 0 7 0 7 1
1 1 1 1 1 1 1 1 1 1 1 1 1 1 1 1 1 1 1 1 1 1 1 1